20 15
CCCCCCCCCCCCCCCCCCCC
R..................L
R..................L
R..................L
R........LR........L
R........LR........L
R........LCCCR.....L
R..................L
R..................L
CCCR...............L
R..............LR..L
R..................L
R.....LCCCR........L
R..............LR..L
CCCCCCCCCCCCCCCCCCCC
